1091307526 12345 81.169.170.126 1488 1489 7 131331
1091307526 12345 66.57.249.182 2190 1337 3 131331
1091307526 12345 82.72.204.45 2185 3161 7 131331
1091307526 12345 212.123.142.156 1215 2216 3 131331
1091307526 12345 62.108.199.166 1875 2326 3 131331
1091307526 12345 69.198.86.95 1215 1216 3 131331
1091307526 12345 209.142.155.49 1748 1257 3 131331
1091307526 12345 62.72.229.10 2107 2935 3 131331
1091307526 12345 24.113.98.95 1215 1216 3 131331
1091307526 12345 82.182.83.9 1215 2216 3 131331
1091307526 12345 213.229.63.69 1215 1216 3 131331
1091307526 12345 64.171.20.181 2322 1649 3 131331
1091307526 12345 24.219.187.245 2203 2283 3 131331
1091307526 12345 68.227.187.44 1486 2817 3 131331
1091307526 12345 217.123.21.225 1215 2216 3 131331
1091307526 12345 68.106.187.18 2215 2216 3 131331
1091307526 12345 24.37.39.44 1860 2505 3 131331
1091307526 12345 217.121.206.142 1215 1216 3 131331
1091307526 12345 66.76.231.32 1215 1216 3 131331
1091307526 12345 213.64.136.199 1215 1216 3 131331
1091307526 12345 216.188.249.86 1215 1216 3 131331
1091307526 12345 212.83.86.228 1926 2746 3 131331
1091307526 12345 216.53.148.194 1633 3123 3 131331
1091307526 12345 193.202.89.71 2097 3191 3 131331
1091307526 12345 24.165.83.165 1215 1216 3 131331
1091307526 12345 24.9.94.94 1215 2216 3 131331
1091307526 12345 213.10.219.25 1215 1216 3 131331
1091307526 12345 18.248.2.195 1712 3133 3 131331
1091307526 12345 24.232.9.197 1215 1216 3 131331
1091307526 12345 204.116.128.9 1215 2216 3 131331
1091307526 12345 212.127.239.220 1215 1216 3 131331
1091307526 12345 68.148.173.190 1215 1216 3 131331
1091307526 12345 69.193.234.11 1367 2746 3 131331
1091307526 12345 66.26.40.240 1215 1216 3 131331
1091307526 12345 81.70.52.115 1215 1216 3 131331
1091307526 12345 220.240.157.42 17451 17452 3 131331
1091307526 12345 82.215.8.135 1215 1216 3 131331
1091307526 12345 4.64.67.109 1215 2216 3 131331
1091307526 12345 210.16.59.25 2021 3040 3 131331
1091307526 12345 83.73.128.144 1215 2216 3 131331
1091307526 12345 200.109.141.177 1488 3097 3 131331
1091307526 12345 82.72.127.238 1215 1216 3 131331
1091307526 12345 142.165.59.202 2118 2401 3 131331
1091307526 12345 24.53.246.108 1215 1216 3 131331
1091307526 12345 80.242.251.210 1215 1216 3 131331
1091307526 12345 213.10.250.33 1215 1216 3 131331
1091307526 12345 216.126.89.40 1547 2264 3 131331
1091307526 12345 82.66.93.83 1486 2817 3 131331
1091307526 12345 12.181.64.179 1215 1216 3 131331
1091307526 12345 4.5.83.242 1215 1216 3 131331
1091307526 12345 68.144.50.248 2175 3079 3 131331
1091307526 12345 200.181.246.238 2121 2399 3 131331
1091307526 12345 213.84.186.61 1215 1216 3 131331
1091307526 12345 12.176.128.79 1215 2216 3 131331
1091307526 12345 147.251.2.77 1408 1987 3 131331
1091307526 12345 64.216.203.98 1215 1216 3 131331
1091307526 12345 24.235.215.217 1215 1216 3 131331
1091307526 12345 82.72.160.152 1215 1216 3 131331
1091307526 12345 69.22.8.26 7020 7021 3 131331
1091307526 12345 82.156.219.14 1215 1216 3 131331
1091307526 12345 202.0.62.169 1754 2652 3 131331
1091307526 12345 210.119.108.140 1215 2216 7 131331
1091307526 12345 24.232.78.199 1215 2216 3 131331
1091307526 12345 200.185.163.155 1486 2817 3 131331
1091307526 12345 24.82.47.225 1215 2216 3 131331
1091307526 12345 80.87.128.99 1372 3199 3 131331
1091307526 12345 195.97.30.70 1215 1216 3 131331
1091307526 12345 201.2.197.5 1239 2412 3 131331
1091307526 12345 12.222.42.100 1215 1216 3 131331
1091307526 12345 129.241.62.77 1831 2518 3 131331
1091307526 12345 217.123.13.82 1215 1216 3 131331
1091307526 12345 82.74.160.123 1215 1216 3 131331
1091307526 12345 80.126.79.219 1215 1216 3 131331
1091307526 12345 82.68.52.78 2376 2683 3 131331
1091307526 12345 62.174.223.20 1215 1216 3 131331
1091307526 12345 24.141.198.236 1215 1216 3 131331
1091307526 12345 66.31.202.118 1215 2216 3 131331
1091307526 12345 82.182.71.245 1215 1216 3 131331
1091307526 12345 81.207.105.193 1215 2216 3 131331
1091307526 12345 80.3.44.145 1215 1216 3 131331
1091307526 12345 82.227.62.5 1215 2216 3 131331
1091307526 12345 150.164.232.150 1414 2807 3 131331
1091307526 12345 219.154.126.51 1215 1216 3 131331
1091307526 12345 12.215.41.131 1215 1216 3 131331
1091307526 12345 68.184.118.15 1909 2644 3 131331
1091307526 12345 80.4.248.16 1215 1216 3 131331
1091307526 12345 24.222.135.234 1215 1216 3 131331
1091307526 12345 81.83.230.212 1215 1216 3 131331
1091307526 12345 195.249.89.15 1215 1216 3 131331
1091307526 12345 82.74.144.137 1215 1216 3 131331
1091307526 12345 80.110.29.144 1215 2216 3 131331
1091307526 12345 217.98.195.26 1215 1216 3 131331
1091307526 12345 82.72.12.7 1215 1216 3 131331
1091307526 12345 217.123.159.251 1215 1216 3 131331
1091307526 12345 84.104.9.77 1215 1216 3 131331
1091307526 12345 217.122.128.186 1215 1216 3 131331
1091307526 12345 62.195.142.178 1215 1216 3 131331
1091307526 12345 150.162.65.3 1570 2265 3 131331
1091307526 12345 145.53.155.167 1215 1216 3 131331
1091307526 12345 212.238.235.130 1215 1216 3 131331
1091307526 12345 81.164.65.116 1215 1216 3 131331
1091307526 12345 82.224.219.70 1215 2216 7 131331
1091307526 12345 63.197.150.43 1215 1216 3 131331
1091307526 12345 69.76.185.125 1215 2216 3 131331
1091307526 12345 80.75.128.53 1215 1216 3 131331
1091307526 12345 82.157.153.80 1215 1216 3 131331
1091307526 12345 82.72.42.223 1215 1216 3 131331
1091307526 12345 81.68.132.247 1215 1216 3 131331
1091307526 12345 62.238.40.119 1215 1216 3 131331
1091307526 12345 83.118.13.97 1215 1216 3 131331
1091307526 12345 82.151.163.7 1215 1216 3 131331
1091307526 12345 81.165.26.53 1215 1216 3 131331
1091307526 12345 82.217.27.93 1215 1216 3 131331
1091307526 12345 82.72.198.115 1215 1216 3 131331
1091307526 12345 82.72.88.154 1215 1216 3 131331
1091307526 12345 24.103.151.178 1215 1216 3 131331
1091307526 12345 68.109.54.147 1215 1216 3 131331
1091307526 12345 62.131.238.253 1215 1216 3 131331
1091307526 12345 82.32.115.29 1534 2780 3 131331
1091307526 12345 62.100.26.111 1215 1216 3 131331
1091307526 12345 82.74.78.84 1215 1216 3 131331
1091307526 12345 24.156.131.27 1215 1216 3 131331
1091307526 12345 141.37.66.6 1215 2216 7 131331
1091307526 12345 198.31.228.120 1215 2216 3 131331
1091307526 12345 212.64.4.242 1215 1216 3 131331
1091307526 12345 219.154.192.139 1215 1216 3 131331
1091307526 12345 198.53.41.2 1215 1216 3 131331
1091307526 12345 213.10.224.62 1215 1216 3 131331
1091307526 12345 81.70.24.32 1215 2216 3 131331
1091307526 12345 82.77.1.25 1215 1216 3 131331
1091307526 12345 222.88.64.17 1215 1216 3 3
1091307526 12345 62.238.10.251 1215 1216 3 131331
1091307526 12345 82.217.185.189 1215 1216 3 131331
1091307526 12345 82.32.13.1 1215 1216 3 131331
1091307526 12345 81.98.59.60 1215 1216 3 131331
1091307526 12345 80.100.112.75 1215 1216 3 131331
